Kwa  	Lachancea waltii              	Saccharomycotina  	Duke        
Ppa  	Pichia pastoris               	Saccharomycotina  	JGI         
Pst  	Scheffersomyces stipitis      	Saccharomycotina  	JGI         
Sba  	Saccharomyces bayanus         	Saccharomycotina  	YGOB        
Skl  	Lachancea kluyveri            	Saccharomycotina  	Genolevures 
Zro  	Zygosaccharomyces rouxii      	Saccharomycotina  	JGI         
Che  	Cochliobolus heterostrophus   	Pezizomycotina    	JGI         
Afl  	Aspergillus flavus            	Pezizomycotina    	JGI         
Aor  	Aspergillus oryzae            	Pezizomycotina    	JGI         
Cpr  	Cryphonectria parasitica      	Pezizomycotina    	JGI         
Pan  	Podospora anserina            	Pezizomycotina    	JGI         
Cpp  	Candida parapsilosis          	Saccharomycotina  	BroadInstitute
Ctr  	Candida tropicalis            	Saccharomycotina  	BroadInstitute
Fox  	Fusarium oxysporum            	Pezizomycotina    	BroadInstitute
Gze  	Gibberella zeae               	Pezizomycotina    	JGI         
Trb  	Trichophyton rubrum           	Pezizomycotina    	BroadInstitute
Sca  	Naumovia castellii            	Saccharomycotina  	YGOB        
Spa  	Saccharomyces paradoxus       	Saccharomycotina  	TheHyphalTip
Val  	Verticillium albo-atrum       	Pezizomycotina    	BroadInstitute
Abr  	Alternaria brassicicola       	Pezizomycotina    	JGI         
Tvi  	Hypocrea virens               	Pezizomycotina    	JGI         
Ndi  	Neurospora discreta           	Pezizomycotina    	JGI         
Ggr  	Glomerella graminicola        	Pezizomycotina    	BroadInstitute
Ure  	Uncinocarpus reesii           	Pezizomycotina    	BroadInstitute
Tto  	Trichophyton tonsurans        	Pezizomycotina    	BroadInstitute
Tts  	Thielavia terrestris          	Pezizomycotina    	JGI         
Clu  	Clavispora lusitaniae         	Saccharomycotina  	BroadInstitute
Tme  	Tuber melanosporum            	Pezizomycotina    	KEGG        
Nte  	Neurospora tetrasperma        	Pezizomycotina    	JGI         
Aco  	Aspergillus carbonarius       	Pezizomycotina    	JGI         
Pti  	Pyrenophora tritici-repentis  	Pezizomycotina    	BroadInstitute
Tre  	Hypocrea jecorina             	Pezizomycotina    	JGI         
Mgm  	Mycosphaerella graminicola    	Pezizomycotina    	JGI         
Abe  	Arthroderma benhamiae         	Pezizomycotina    	BroadInstitute
Tve  	Trichophyton verrucosum       	Pezizomycotina    	BroadInstitute
Teq  	Trichophyton equinum          	Pezizomycotina    	BroadInstitute
Tat  	Trichoderma atroviride        	Pezizomycotina    	JGI         
Mii  	Mycosphaerella pini           	Pezizomycotina    	JGI         
Chg  	Colletotrichum higginsianum   	Pezizomycotina    	BroadInstitute
Mfi  	Mycosphaerella fijiensis      	Pezizomycotina    	JGI         
Mpo  	Mycosphaerella populorum      	Pezizomycotina    	JGI         
Sku  	Saccharomyces kudriavzevii    	Saccharomycotina  	TheHyphalTip
Smi  	Saccharomyces mikatae         	Saccharomycotina  	TheHyphalTip
Fve  	Gibberella moniliformis       	Pezizomycotina    	BroadInstitute
Nha  	Nectria haematococca          	Pezizomycotina    	JGI         
Ani  	Aspergillus nidulans          	Pezizomycotina    	JGI         
Cal  	Candida albicans              	Saccharomycotina  	BroadInstitute
Mor  	Magnaporthe oryzae            	Pezizomycotina    	JGI         
Cim  	Coccidioides immitis          	Pezizomycotina    	BroadInstitute
Kla  	Kluyveromyces lactis          	Saccharomycotina  	Genolevures 
Yli  	Yarrowia lipolytica           	Saccharomycotina  	Genolevures 
Dha  	Debaryomyces hansenii         	Saccharomycotina  	Genolevures 
Cgl  	Candida glabrata              	Saccharomycotina  	Genolevures 
Ago  	Ashbya gossypii               	Saccharomycotina  	YGOB        
Spb  	Schizosaccharomyces pombe     	Schizosaccharomycetes	BroadInstitute
Mgd  	Meyerozyma guilliermondii     	Saccharomycotina  	JGI         
Cgo  	Chaetomium globosum           	Pezizomycotina    	JGI         
Pno  	Phaeosphaeria nodorum         	Pezizomycotina    	JGI         
Nfi  	Neosartorya fischeri          	Pezizomycotina    	JGI         
Bci  	Botryotinia fuckeliana        	Pezizomycotina    	JGI         
Acs  	Ajellomyces capsulatus        	Pezizomycotina    	JGI         
Ate  	Aspergillus terreus           	Pezizomycotina    	JGI         
Acl  	Aspergillus clavatus          	Pezizomycotina    	JGI         
Ncr  	Neurospora crassa             	Pezizomycotina    	JGI         
Lel  	Lodderomyces elongisporus     	Saccharomycotina  	JGI         
Lth  	Lachancea thermotolerans      	Saccharomycotina  	JGI         
Sja  	Schizosaccharomyces japonicus 	Schizosaccharomycetes	BroadInstitute
Ang  	Aspergillus niger             	Pezizomycotina    	JGI         
Kpo  	Vanderwaltozyma polyspora     	Saccharomycotina  	YGOB        
Afu  	Aspergillus fumigatus         	Pezizomycotina    	BroadInstitute
Cpd  	Coccidioides posadasii        	Pezizomycotina    	BroadInstitute
Soc  	Schizosaccharomyces octosporus	Schizosaccharomycetes	BroadInstitute
Mgy  	Microsporum gypseum           	Pezizomycotina    	BroadInstitute
Vda  	Verticillium dahliae          	Pezizomycotina    	BroadInstitute
Pcm  	Penicillium chrysogenum       	Pezizomycotina    	JGI         
Pbr  	Paracoccidioides brasiliensis 	Pezizomycotina    	BroadInstitute
Aot  	Arthroderma otae              	Pezizomycotina    	BroadInstitute
Sce  	Saccharomyces cerevisiae      	Saccharomycotina  	SGD         
Bdr  	Ajellomyces dermatitidis      	Pezizomycotina    	BroadInstitute
Mta  	Myceliophthora thermophila    	Pezizomycotina    	JGI         
Cdu  	Candida dubliniensis          	Saccharomycotina  	KEGG        
Ssc  	Sclerotinia sclerotiorum      	Pezizomycotina    	JGI         
Scr  	Schizosaccharomyces cryophilus	Schizosaccharomycetes	BroadInstitute
